NO ./cobblestone.png
SO ./cobblestone.png
WE ./cobblestone.png
EA ./cobblestone.png
F 128, 64,  0
C 112,163,204
111111111111111111111111111111
100000000000000000000000000001
100000000101000000000000000001
1E0000001010100000000000000001
100000000000000000000000000001
111111111111111111111111111111
