NO ./path_to_the_north_texture
SO ./path_to_the_south_texture
WE ./path_to_the_west_texture
EA ./path_to_the_east_texture
F 255,255,255
C 0,255,0

111
11111111         11111
111         1111111111
         11111111N1111
1111111111111111111111
111
111
111
111
