NO ./path_to_the_north_texture     
SO ./path_to_the_south_texture    
WE ./path_to_the_west_texture
EA ./path_to_the_east_texture    
F 1,2,4
C 8,16,32
        1111111111111111111111111        0
        1000000000110000000000001     0
        101100000111000000000000100000
        1001000000000000000000001
111111111011000001110000000000001
100000000011000001110111110111111
11110111111111011100000010001
11110111111111011101010010001     0
11000000110101011100000010001
10          00001100000010001
10000000000000001101010010001
11000001110101011111011110N0111
11110111 1110101 101111010001
11111111 1111111 111111111111
