NO ./path_to_the_north_texture     
SO ./path_to_the_south_texture    
WE ./path_to_the_west_texture
EA ./path_to_the_east_texture    
F 128, 64,  0
C 112,163,204
11111111111111111111111111111111111111111111111111111111111111111111111
10000000000000000000000000000000000000000000000000000000000000000000001
10000000010100000000000000000000000000000000000000000000000000000000001
1E000000101010000000000000000000000000000000000000000000000000000000001
10000000000000000000000000000000000000000000000000000000000000000000001
11111111111111111111111111111111111111111111111111111111111111111111111
